25
13
0000000000000000000000000
0301111101111110001000110
0101010101000011111110100
0111110101011010100010100
0100011101010010111011111
0101010001011010000010001
0111011101001110110010101
0010110101011000101110101
0111100101010010101001101
01001011110111111110010010111101001000000011111001
0010011111111111100000004
0000000000000000000000000
