71
56
'000000000000000000000000000000000000000000000000000000000000000000000002'+
'031111111111111111111111111111111111111111111111111111111111111111111102'+
'011111111111111111111111111111111111111111111111111111111111111111111102'+
'011111111111111111111111111111111111111111111111111111111111111111111102'+
'011111111111111111111111111111111111111111111111111111111111111111111102'+
'011111111111111111111111111111111111111111111111111111111111111111111102'+
'011111111111111111111111111111111111111111111111111111111111111111111102'+
'011111111111111111111111111111111111111111111111111111111111111111111102'+
'011111111111111111111111111111111111111111111111111111111111111111111102'+
'011111111111111111111111111111111111111111111111111111111111111111111102'+
'011111111111111111111111111111111111111111111111111111111111111111111102'+
'011111111111111111111111111111111111111111111111111111111111111111111102'+
'011111111111111111111111111111111111111111111111111111111111111111111102'+
'011111111111111111111111111111111111111111111111111111111111111111111102'+
'011111111111111111111111111111111111111111111111111111111111111111111102'+
'011111111111111111111111111111111111111111111111111111111111111111111102'+
'011111111111111111111111111111111111111111111111111111111111111111111102'+
'011111111111111111111111111111111111111111111111111111111111111111111102'+
'011111111111111111111111111111111111111111111111111111111111111111111102'+
'011111111111111111111111111111111111111111111111111111111111111111111102'+
'011111111111111111111111111111111111111111111111111111111111111111111102'+
'011111111111111111111111111111111111111111111111111111111111111111111102'+
'011111111111111111111111111111111111111111111111111111111111111111111102'+
'011111111111111111111111111111111111111111111111111111111111111111111102'+
'011111111111111111111111111111111111111111111111111111111111111111111102'+
'011111111111111111111111111111111111111111111111111111111111111111111102'+
'011111111111111111111111111111111111111111111111111111111111111111111102'+
'011111111111111111111111111111111111111111111111111111111111111111111102'+
'011111111111111111111111111111111111111111111111111111111111111111111102'+
'011111111111111111111111111111111111111111111111111111111111111111111102'+
'011111111111111111111111111111111111111111111111111111111111111111111102'+
'011111111111111111111111111111111111111111111111111111111111111111111102'+
'011111111111111111111111111111111111111111111111111111111111111111111102'+
'011111111111111111111111111111111111111111111111111111111111111111111102'+
'011111111111111111111111111111111111111111111111111111111111111111111102'+
'011111111111111111111111111111111111111111111111111111111111111111111102'+
'011111111111111111111111111111111111111111111111111111111111111111111102'+
'011111111111111111111111111111111111111111111111111111111111111111111102'+
'011111111111111111111111111111111111111111111111111111111111111111111102'+
'011111111111111111111111111111111111111111111111111111111111111111111102'+
'011111111111111111111111111111111111111111111111111111111111111111111102'+
'011111111111111111111111111111111111111111111111111111111111111111111102'+
'011111111111111111111111111111111111111111111111111111111111111111111102'+
'011111111111111111111111111111111111111111111111111111111111111111111102'+
'011111111111111111111111111111111111111111111111111111111111111111111102'+
'011111111111111111111111111111111111111111111111111111111111111111111102'+
'011111111111111111111111111111111111111111111111111111111111111111111102'+
'011111111111111111111111111111111111111111111111111111111111111111111102'+
'011111111111111111111111111111111111111111111111111111111111111111111102'+
'011111111111111111111111111111111111111111111111111111111111111111111102'+
'011111111111111111111111111111111111111111111111111111111111111111111102'+
'011111111111111111111111111111111111111111111111111111111111111111111102'+
'011111111111111111111111111111111111111111111111111111111111111111111102'+
'011111111111111111111111111111111111111111111111111111111111111111111102'+
'011111111111111111111111111111111111111111111111111111111111111111111402'+
'000000000000000000000000000000000000000000000000000000000000000000000002';
