const maze = 
'00000000000000000000000000000000000004000000000000000000000002'+
'01111111111111110111111111111111110101111101111101111101111102'+
'01000000000000010100000000000001010100000101000100010101000102'+
'01011111011111110101111111111101010111110101011111110101011102'+
'01010001010000000101000000000001010001010101000000000101010002'+
'01011101011111110101111101111111011111010101110111111101011102'+
'01010100000000010101000101000001000000000100010100000001000002'+
'01010101111111110101110101011101011111110101110111111111011102'+
'01010101000000010101000101010101010000010101010000000000010102'+
'01010101011111010101011101010101010111010101010111111111110102'+
'01000101010100010101010001010101010101010101010100000000000102'+
'31111101010101110101011101010101010101011101010111011111110102'+
'00000001010001000101000101010101010101000001010001010000010102'+
'01111111010111011101010101010111010101011111010101010111010102'+
'01000000010100010001010101000000010100010001010101010101000102'+
'01011111110111010111010101111111110111111101010101010101011102'+
'01010000010001010100010100000000000000000001010101010101010102'+
'01011111011101010111110111111111111111111101011101110101110102'+
'01000000010001010000000100000000000000000101000000010100000102'+
'01111111011101011111111101110111111111110101111111110101110102'+
'01000001010101000000000001010100000000010100000000000101010102'+
'01011101010111110111111111010101110111110101111111111101010102'+
'01000101000000000100000100010101010100010101000000000001010102'+
'01011101111111110101110101110111010101010101111111111101010102'+
'01010000000000010101010101000000000101010101000000000101010102'+
'01011111111111010101010101011111111101110101110111111101010102'+
'01000001000001010101010101010000000001000100000100000001000102'+
'01111111011111010101010101010101111101010101111101110111110102'+
'00000100000000010101000101010101010101010101000001010100010102'+
'01111101111111010101110101010101010101110111011111010111011102'+
'01000001000001010100010101010101010000010000010001010001000002'+
'01011101011101010111010101010101011111111111010111011101011102'+
'01010001010101010001010101010101000000000000010100000001010002'+
'01010111010101011111110101110101011111011111110111111111011102'+
'01010100010001000000000100000101010001010000000000000000000102'+
'01010101111111111111111101111111011101010111111111110111111102'+
'01010100000000000000000000000001010001010100000000010101000102'+
'01110101111111111111111111111101010111010101111111110101010102'+
'00000101000000000000000000000101010100010101000000000001010102'+
'01111101111111010111110111110101010111011101011111111111010102'+
'01000100000001010101010000010101010001000001000001000000010102'+
'01010101111101010101011111110101010101111101111101111111010102'+
'01010101000101010101000000010101010101000100000100000001010102'+
'01011101010101010101011111010101011101011111110111111111011102'+
'01010001010101010101010001010101000001000000000000000000010002'+
'01011101010111011101010101010101111111011111111111111111010102'+
'01000001010000000101010101010100000001010000000000000001010102'+
'01111111010111110101010101010101111101011101111111110111010102'+
'01000000010101010101010101010101000001000101010000000101010102'+
'01011101110101010101010101010101111111110101011101111101010102'+
'01010101000101010101010101010101000000010100000101000001010102'+
'01010101111101010101010101010101110111010101111101011101010102'+
'01010100000001010101010101010100000101010101000101010101010102'+
'01010111111111010101011101110111111101010101010101010101010102'+
'01010000000000010001010000000000000101010101010101010101010102'+
'01010111011101010111010111111111110101010101011101010101010102'+
'01010101010101010100010100000000010001010101000001010101010102'+
'01010101110111010101110101111111111111010101011111010111010102'+
'01010100000000010101000100000000000000000101010000000000010102'+
'01110111111111111101110111111111111111111111011111111111111102'+
'0000000000000000000000000000000000000000000000000000000000000';
