61
61
0000000000000000000000000000000000000000000000000000000000000
0111111111111100111111111111111111111111111111111111111110000
0101000000000000100000000001000000000000000000000000000010000
0101000000000000100100000001000111110000000000000000000010000
0101000111111111100100000001000100000011111111111111110010000
0101011101000100000111110001000100000010000000000000010010000
0101010001000100000000010001000100000010000000000000010010000
0101010001000100111111110001111111111110011100000000010010000
0101011101011100000000010000000000000000000100000000010010000
0101000001000000000000010011111111111111100111111100010010000
0101111111111111111100010010000000000000000100000100010010000
0100010000000000000100010011111111111111111100000100010011110
0100011110000001000101110010000000000000000000000100010000010
0100010010100001000101010010000000000000000000000100010000010
0100010010111111111101010010011111111111111111111100010100010
0111010000000001000101010010010000000001000010000111110100010
0000011111100001000101011110010010000001000010000000000100010
0000010000001111000101010000010010000001001010111111111100010
3111111110100000000101010100010010000001001010100000000000010
0000000010101111111101010100011111100001111010100000111110010
0111111010101000001001010100010000100100000010100000100011110
0100001010101000001001010100010000100100000010100000100000000
0101101010101001001111010100010011100111110010100111100000000
0100101010101001001000010111110000000100000010100000100000100
0100101010101001001000010000100000000100000010100000100000100
0100101010101001111001110000100011111100111110100000111111100
0100111010101000001001000000100010000100100010100000100000000
0100000010101111101001000000100010000100100010111111100000000
0100000010100000101001001111100010000100100010000000100000000
0111111111100000101001001000100000000100000010000000100000000
0010100001000000101001001000111111111111111111111111111111114
0010100001000100101001001000100000000000001001010010000000000
0010111101010100101000001000100000000000001001010010000000000
0010000101010100101111101000100011111111101001010011111110000
0010000101010111101000101000100010000000001001010000000010000
0111110101010000001000101000100010011111001001011111110010000
0100000101011111111000100000100010010000001001000000010011110
0100111101000000001000000000100010111111111001000000010000010
0100000001111111111111111111111110100000000001110000010000010
0100000000000000000000000000000000100011110100011110010000010
0101111111111111111111111101111111100010000100010010010000010
0101000000000000000000000101000000100010010100010010010000010
0101000000111111111111100101100000100010010100010010010111110
0101000000100000000000100100111110111110010100010010010100000
0101000000100000000000100100000010101000010111110010010100000
0101011111111111111100100101111110101000010000000010010101110
0101010000000010000100100100000000101000010000000000010101010
0101010111111010000110100111111111101011111111111111110101010
0101010100001010000010100000000000001000100000000000000101010
0101010111101010000010100000000000001000100000000000000101010
0101010000101010000010100000111100001010111111111111111101010
0101011111101011111010100000100100101110100000000000000101010
0101000000001010001010111111100100100000100011111111100101010
0101111111111010101010100000000100100000100010000000000101010
0100000000000010101010100000000100100000100010000000000101010
0111111111111110101010100000000000101111100010000000000101010
0100000000000000101010100001111111100000100010111111111101010
0100111111111111101010100001000000000000100011100000100000010
0100100000000000001010111111111000000000100000000000100000010
0110111111111111111010000000001111111111101111111111111111110
0000000000000000000000000000000000000000000000000000000000000
